##############################################
#       #    #     #    #    #   ..........  #
#   #   #  ................  ###########     #
#####   ############## ..........  #  ...... #
#   #   ....  #           #        #   #     #
# ....  #     # ........  # .....  #####     #
###########        ############ .............#
#  ............ ####    #   ................ #
#  .................... #########  ########  #
#       #  ...................  ####      #  #
#  .... # .... #####    #########  #   #     #
#       #      #   #            #  #   #     #
#       ########   #    ######         #     #
#       #      #        #    #####  ........ #
########    #############    #     #   #     #
#  .....    #     .............    #  .....  #
##############################################